2 2 2 2 2 2 2 2 2 2 2 2 2 2 2 2
2 3 7 8 6 3 7 3 8 0 3 7 8 0 3 2
5 1 1 1 1 1 1 1 1 1 1 1 1 1 8 2
2 3 1 6 7 8 0 1 8 7 1 8 0 1 7 2
2 7 1 7 0 6 7 1 8 3 1 6 8 1 3 2
2 8 1 0 1 1 1 1 1 1 1 1 1 1 8 2
2 3 1 8 1 6 8 7 3 1 3 1 3 1 1 5
2 6 1 3 1 8 4 4 8 1 8 1 0 1 3 2
2 3 1 7 1 0 6 0 8 1 7 1 8 1 6 2
2 7 1 1 1 1 1 1 1 1 1 1 1 1 3 2
2 8 7 7 8 3 6 3 7 8 3 8 7 3 8 2
2 2 2 2 2 2 2 2 2 2 2 2 2 2 2 2