2 2 2 2 2 2 2 2 2 2 2 2 2 2 2 2
2 7 3 8 3 0 7 8 3 8 3 8 7 3 8 2
2 8 1 1 1 1 1 1 1 6 1 1 1 3 7 2
2 3 1 0 6 8 1 8 1 3 1 8 1 3 7 2
2 8 1 3 4 3 1 0 1 7 1 3 1 3 3 2
2 7 1 0 4 6 1 7 1 8 1 3 1 1 8 2
2 3 1 8 3 7 1 3 1 3 1 8 3 1 3 2
5 1 1 1 1 1 1 8 1 7 1 1 1 1 8 2
2 8 1 3 0 7 8 3 1 8 1 6 3 1 7 2
2 0 1 1 1 1 1 1 1 1 1 1 1 1 0 2
2 7 8 3 7 3 8 6 3 0 8 3 0 1 1 5
2 2 2 2 2 2 2 2 2 2 2 2 2 2 2 2