2 2 2 2 2 2 2 2 2 2 2 2 2 2 2 2
2 3 0 8 7 6 7 8 0 3 7 8 3 7 6 2
5 1 1 7 1 1 1 6 1 1 1 1 1 1 3 2
2 3 1 8 1 7 1 3 1 6 1 3 7 1 3 2
2 0 1 3 1 6 1 7 1 7 1 3 6 1 3 2
2 7 1 0 1 7 1 8 1 3 1 1 1 1 3 2
2 3 1 6 1 0 1 6 1 8 1 7 3 0 3 2
2 6 1 3 1 3 1 7 1 7 1 3 4 4 3 2
2 3 1 8 1 8 1 3 1 3 1 7 8 6 3 2
2 8 1 1 1 7 1 1 1 1 1 1 1 1 6 2
2 0 6 7 3 8 7 3 7 0 6 7 6 1 1 5
2 2 2 2 2 2 2 2 2 2 2 2 2 2 2 2