2 2 2 2 2 2 2 2 2 2 2 2 2 2 2 2
2 3 7 8 6 3 7 3 8 0 3 7 8 0 3 2
2 8 1 1 1 3 1 1 1 1 1 1 1 1 8 2
2 3 1 6 1 8 1 0 8 8 1 6 3 1 7 2
2 7 1 7 1 6 1 3 4 8 1 3 8 1 3 2
2 8 1 0 1 1 1 8 4 7 1 8 6 1 8 2
2 3 1 8 1 6 1 3 4 6 1 3 3 1 1 5
2 6 1 3 1 8 1 8 4 0 1 8 0 1 3 2
2 3 1 7 1 7 1 3 6 7 1 8 8 1 6 2
5 1 1 3 1 1 1 1 1 1 1 1 1 1 3 2
2 8 7 7 8 3 7 3 7 8 3 8 7 3 8 2
2 2 2 2 2 2 2 2 2 2 2 2 2 2 2 2