2222222222222222
2383738373838372
5111184431111132
2380187331837182
2740111111111132
2308177831387172
2811136671063182
2310111111738172
2716078671111132
2318744480007132
2813873633337115
2222222222222222